14
1,7,5,5,5,7,6,3,5,6,3,5,5,6
1,13,5,6,3,12,10,10,3,12,10,3,4,10
3,5,6,10,9,6,9,12,10,1,14,11,6,10
9,6,10,9,6,10,3,6,9,5,12,10,9,12
3,12,9,4,10,10,10,9,6,3,6,10,3,6
11,5,5,6,10,10,9,6,9,12,10,9,12,10
9,6,2,9,12,8,3,14,3,5,13,5,6,10
2,10,11,5,5,6,11,12,9,6,3,5,12,10
10,9,12,1,6,10,10,3,5,12,10,3,5,12
10,3,7,5,14,10,10,10,2,3,12,9,5,6
10,10,10,3,12,10,10,10,11,12,3,6,3,12
10,10,10,9,4,9,12,10,9,6,10,10,9,6
11,12,9,5,5,6,3,13,6,9,12,9,4,10
9,5,5,5,4,9,13,4,9,5,5,5,5,12